20,12
XXXXXXXXXXXXXXXXXXXX
X.......FX.........X
X......XXX.........X
X..................X
X..........P.......X
X.....XXXXXXX......X
X..................X
X..........XXXX....X
X..................X
X......XXX.........X
X.......SX.........X
XXXXXXXXXXXXXXXXXXXX