10,7
XXXXXXXXXX
X........X
X......XXX
X......PPX
X......XXX
X....S...X
XXXXXXXXXX