18,19
XXXXXXXXXXXXXXXXXX
X.........SXXXXXXX
X.XXXXXXXXXXXXXXXX
X................X
XXXXXXXXXX.......X
X................X
X................X
X......X.........X
X.XPPPPXPPPPPPPPXX
X.XXXXXXXXXXXXXXXX
X................X
X................X
X................X
X...X.........X..X
XXXXX..X....X.XFFX
XXXXX..XX..XX.XXXX
XXXXX..XX..XX.XXXX
XXXXX..XXPPXX.XXXX
XXXXX..XXXXXX.XXXX